alex = Alex Groenewoud <alex@linuxfromscratch.org>
alexander = Alexander E. Patrakov <alexander@linuxfromscratch.org>
archaic = Archaic <archaic@linuxfromscratch.org>
balu = Thomas -Balu- Walter <balu@linuxfromscratch.org>
bdubbs = Bruce Dubbs <bdubbs@linuxfromscratch.org>
billyoc = Billy O'Connor <billyoc@linuxfromscratch.org>
bryan = Bryan Kadzban <bryan@linuxfromscratch.org>
craigthulu = Craig M. Reece <craigthulu@earthlink.net>
dj = DJ Lucas <dj@linuxfromscratch.org>
dnicholson = Dan Nicholson <dnicholson@linuxfromscratch.org>
gerard = Gerard Beekmans <gerard@linuxfromscratch.org>
gimli = Marc Heerdink <gimli@linuxfromscratch.org>
greg = Greg Schafer <greg@linuxfromscratch.org>
highos = Jesse Tie-Ten-Quee <highos@linuxfromscratch.org>
jeremy = Jeremy Utley <jeremy@linuxfromscratch.org>
jesse = jesse <jesse@unknown>
jhuntwork = Jeremy Huntwork <jhuntwork@linuxfromscratch.org>
jim = Jim Gifford <jim@linuxfromscratch.org>
jon = jon <jon@linuxfromscratch.org>
jwrober = James Robertson <jwrober@linuxfromscratch.org>
ken = Ken Moffat <ken@linuxfromscratch.org>
manuel = Manuel Canales Esparcia <manuel@linuxfromscratch.org>
markh = Mark Hymers <markh@linuxfromscratch.org>
matthew = Matthew Burgess <matthew@linuxfromscratch.org>
nathan = Nathan Coulson <nathan@linuxfromscratch.org>
nomis80 = Simon Perreault <nomis80@videotron.ca>
randy = Randy McMurchy <randy@linuxfromscratch.org>
robert = Robert Connolly <robert@linuxfromscratch.org>
sklein = Seth W. Klein <sklein@linuxfromscratch.org>
spyro = Ian Molton <spyro@f2s.com>
timothy = Timothy Bauscher <timothy@linuxfromscratch.org>
unknown = cvs2svn <cvs2svn@migration>
winkie = Zach Winkles <winkie@linuxfromscratch.org>
